#################
#......#........#
#.####.#........#
#.####.#.####.#.#
#.####.#.####.#.#
#...............#
#.####.#.####.#.#
#.####.#.####.#.#
#.......P.......#
#################
#.....#...#.....#
#####.#.#.#.#####
......#.#.#......
#####.#.#.#.#####
#.....#...#.....#
#################